"filename", "language", "Vue", "TypeScript", "JSON", "comment", "blank", "total"
"c:\Users\25920\Project\2024\DryHelper\01_Preparation\dry-helper-md\src\App.vue", "Vue", 37, 0, 0, 3, 5, 45
"c:\Users\25920\Project\2024\DryHelper\01_Preparation\dry-helper-md\src\components\BaiduIndex.vue", "Vue", 3, 0, 0, 0, 1, 4
"c:\Users\25920\Project\2024\DryHelper\01_Preparation\dry-helper-md\src\components\DewTemChart.vue", "Vue", 105, 0, 0, 0, 18, 123
"c:\Users\25920\Project\2024\DryHelper\01_Preparation\dry-helper-md\src\components\MapCityToolTip.vue", "Vue", 66, 0, 0, 0, 8, 74
"c:\Users\25920\Project\2024\DryHelper\01_Preparation\dry-helper-md\src\data\dew24h.ts", "TypeScript", 0, 81, 0, 0, 1, 82
"c:\Users\25920\Project\2024\DryHelper\01_Preparation\dry-helper-md\src\data\maps\cn-gd.geo.json", "JSON", 0, 0, 1, 0, 0, 1
"c:\Users\25920\Project\2024\DryHelper\01_Preparation\dry-helper-md\src\data\maps\cn.geo.json", "JSON", 0, 0, 1, 0, 1, 2
"c:\Users\25920\Project\2024\DryHelper\01_Preparation\dry-helper-md\src\data\maps\gd.geo.json", "JSON", 0, 0, 1, 0, 0, 1
"c:\Users\25920\Project\2024\DryHelper\01_Preparation\dry-helper-md\src\main.ts", "TypeScript", 0, 13, 0, 6, 8, 27
"c:\Users\25920\Project\2024\DryHelper\01_Preparation\dry-helper-md\src\router.ts", "TypeScript", 0, 40, 0, 0, 3, 43
"c:\Users\25920\Project\2024\DryHelper\01_Preparation\dry-helper-md\src\views\HuinanReplay.vue", "Vue", 3, 0, 0, 0, 1, 4
"c:\Users\25920\Project\2024\DryHelper\01_Preparation\dry-helper-md\src\views\Map.vue", "Vue", 495, 0, 0, 0, 89, 584
"c:\Users\25920\Project\2024\DryHelper\01_Preparation\dry-helper-md\src\views\Overview.vue", "Vue", 44, 0, 0, 0, 8, 52
"c:\Users\25920\Project\2024\DryHelper\01_Preparation\dry-helper-md\src\views\Stats.vue", "Vue", 6, 0, 0, 0, 2, 8
"c:\Users\25920\Project\2024\DryHelper\01_Preparation\dry-helper-md\src\views\StatsRoot.vue", "Vue", 17, 0, 0, 0, 4, 21
"Total", "-", 776, 134, 3, 9, 149, 1071